>Rosalind_3084
GGGTTTCGCCCTGGTTTCGGATAATTGTGAGCAATGCCCGGCGCCTCCGGGCCCGCTTGA
AAGTGTCATAACCCCATGCGCACTTGCTTTTGAAACTACGATCACCCTTACTTAGTAGGG
CGGCGCTCCTCCAGCACTAACATGGGTTCTGGTGAGCCACGTACGAACTTGGATGTTCGC
AGCTCCTACACAGTGTTTATATCGAGAGTATATGCCACCAATTGTTTCAGACTCCTCCCA
TCACCAATCACAGACCACTTTTAGTCAGAGGGGAATGGGAATTTACCACCAGACCGAAAC
GTACGCACCCAAAGGGACTGATGCCCCTTTCGGGCGAACGCAGTGATGGCGTAGTGAGAT
ACCGCGTGCTGATCAGTTGACAAAGATGAAGCGGCGTAATTCACGAGGCACATCGATGTG
CAGAATACTCAGACCCTCCCATTTGCTACTGCCTCTCGCCAGCTGTGTTCGGGGCCCAGA
TCGATGGTCCAAACGCCGCCTCCCCTTTTCTAGGGTATTCCGATCCCACCGCGGGACGAA
AATCAGTTTCGACCCAATTCGAGACGGAAAGATGTGAAACTCTCCCGCTTTTCAAAGAGG
ACATCAGCTCCAAGTTCTACGCGGTGGAGCGTAGTCTTAGCCAGTTTTGAACGGGCACGA
CAGTACATAAGGCTCCCGAACAGCCGATAGAGCCGTGCTGCTACCTCAGGGATTAAAATA
GGCCGTTCTGTATCGCGAATGATAGCGTGGACGGTGTGACAGAGCTATGCTCATGTGTAA
GGGATCCGTCGTAGCATTCGTTCCTGGCCTGGGGTTCCTCCTGGTCTGTTGACGGGCCGC
TTGCTGGGTGAGCTTTGACTCGCCCACACGCAGGTTCCTAGAAACGCGATAATCGCCGTT
GGATAACTTAATCGAGGGGCCCCCTAGCCTTTTCCGAACGCAGTGACATCAGTTCGAGCT
CGCCTTGGACG
>Rosalind_5982
AACGGGTGGGGAGCGCAATCAGCTGCCTCCCCACCTCATCGCCCAATGTTCGCGCGCTAG
GGCTTACGTGTTAGGCTATTTCCTAGTATTGCGTACTTCACACTACCTGGAACAAGGTCC
TATTACCTTCGTGCGTATTTTCGCGACCTGGCTGTCCCTGGCTTTTCATAACCAAGCTTA
CTCTTCAACTATAAGCTATTCAATGTGCCGTAGGGTGGGGCGCCATATGGAGGGCCATTG
TATGACGAAGCGCTGTCTCGTTGCTAATGGGAGGTGGTTTATGAACTATCCGCGCTAATA
GACAAAGTGCTAGCGGGCGTGGCATACCTGGCCACACTTTCTCCGAGACAAGTCTAACGC
TTCTATAAGTCCTTAGTAATTTTTGTCGTCTGGAATCTACGTTAGGATCCCGAAGAGAAC
ACTTACTCTTCATGTACTTCCGAAGAAGTCGCTAGCCTCAACCTCTCTATGAATTCAATT
GGACGGGAGATCGCGAAGTCAAATTAGCCGGTTAACGCCGCTGTTATTCGGACGGTCCAA
AATTGATCTCGGGGCGGAGGGGAAGGATTTAAGTCGTCGAGTGGTAGGGTGTTGCGACAC
CAGCTCGGTCCAAGAAGGGGGGGATGCTACCTTGTGTTTCCTTGTAACGAGGGGAGTTGG
TACCCTCGCCGAGTCATTCTGCCTATCAACAGATCACACATGAAGGCCAGGACGCGACGG
ACAGCGTGACCGATCCTGAAGGGTTGGACTCGTCCTCGATAGGTTGTACTGCCCTGCCGC
AGCTTTTTACGTTGAGAGTAGGCTTGTACTCACTAATGCTGCGTCACCAATAGTGTCCAC
GTGAGATTTGATATTACTAAGTAACCGCCCGACCGGTCTTACGGACATCCCATGGTGCCA
TGGCCGAAGTTAAACTGATGGTGTAACACGAACGATTCGACTGTGAGCTATTGGTTGGAG
GTCCGACCCCA
>Rosalind_0874
GATGCTAATTTCCTGCTCAGTACCAGCCTCGCCAAGGAACTTGCGGTCGACGTTGTTTCA
CTTAAAGCACAAGCGCTCACTCGCTGAGAGCCACGATGTTCGAGTGATGCTTTTGACAAT
TTAGTAACCCACTGAAGGACCGGTACCGTGGAGAAGAAACAGATGCATAGGAGTGGCGCA
CCGGTAAGAAGCTTTGCCCTCGTGCAAGCGTCGTTATACTGCCGTGAGCGCCGACCGTTG
AACCGCATGAGTTACGCCGGGGGATCGTCCATATCCAGTCTGTGGAAATCTTCCAGCTAT
CCGTGCATCGCTTCTTGAGAGTCAATATCGGTAACATATCCAAATCTGTATGACTGCCTA
CCATCCCGTTCTTTTTTTCTTGCGGCATCAGAGTAAGCCTTGGGTTGGAGGTACCCCTTG
GATAGACGAAATGTATCAGGCGTAGCAGCTGACGGCATGATTCGACTTACAGAAAAGGCC
GTACCAATACACACGGACTCGCGATTGCTGCCGCTGTGGCCTCTTACTGGCATTCTTCAA
CTTCGGGCTTCTCACGGCTTCTCGGGTCATTATTTCTGTCCTTAACGCCAAAGCGGGTCC
TATAATGCTCCTCCCAGGTGCGCGTACTGATGCATCGCGGTCGGCCTTCCCCTGGGAATT
CACACAGGACACAATAATTAAGCTGTCCAAGTTTATTCCTCTGGTCAATTAACGAATACG
TCTGCCGACACCATACGCAGGATGCTTGCCAGGCCGCCGCCGCGGACATCGTGCCAACTA
ATGTCGTTCATAACCCATTAAACCTAATCTTGGGTCATAGGGCGCAGGCTAAGGGCACTC
AGCCGTCGAAAAGCCAGCGACCCAGAGCGTGGTCCATAATGAATCGGAGTCTGCCCAGCC
GGCGGATACAATAGAGACTCCATTGTGCTTGGACCTACCAACTACCTCCGATATACAAGA
GTCTGCGCCTC
>Rosalind_8643
CCTACTTATGCTATCCCAGTCGGAATCCGGGGTCCATAGTCTTCGCCACCGTCGCTACTG
TTAATACAGAGTCGTACCGGAACTATTCCGTTACATGCGCAACCCACGGTCCGCGAGGTT
CCGGTACGAACAGTTGTAAGCGTAGAAAACCCTTCACCCTTTAGAGTCGAGCACGAAGTG
ATGGCCCCAATGCGAACTTCAGAAATCTGTCTTGTAGTAGTAGGATTTCTATCTGGGCTT
AAGCTTCTCGGTCACTGAGATGCGTCGACACGCGTTAGAAAATAAGTTTAAGTGCCTTAG
GTTGTAGCGGGGTGGTGAATTGGAGTTGTGTCACAGCTTAGGCTGGGGACGTGAAGGCCA
CATTCGGGACGGTTCAACGATTATATTGTCATCACTTGATACATATGCGCCTTTATGTCT
CGTGACCGCAATGGCCTAGGGCGCTAAGTCGGAAAGGATTGATCTTGGTCTTCTACGCTT
GCTCTGCAGAAGCTATCCGGGCCCTGGATGTATCATGGTTGCCTCTTCCTACATATGGCC
ATGTAGTCGGCGCGTCCGCTGACTCCTACTGCTGTTAATAAGAGCCCGTGAACAGTACCA
CATGGCGAACAGCCGTTCTCCGGTACCGTGGCGGTGGTACCGTTCATTTATAAGAAATCG
ACATGGGCGCTGCTGTATAGTTTCCAAGTCCCCCTTGCCAGGAACTGGTCTTTCGGTTAC
CAGACGGCTCAGACTTCTCGTATAAGGTAGAGATGGCCGGAGCTAACGAAGGCGTCAACG
ACACTCGAAGGATAAGGCGTCACAGTTATTGCGTTACAATACCTTAGCGGATCGCAGTAT
CGACCATACTCTGGAGGGACGATGTATCCGGTTGCGACCTTTTTTGATCGTTCATTGAGG
TGGGCCAATACGCTTTTCGTAGTTGTGCTTATGTCGTAAACTTTTTAACTCCCACCGGAG
AACATGTACTT
>Rosalind_5139
TATCCAACCAGTGTCTCTAGAAAAATCTCCTTTAAGACACCTCCATTACAAAAGCCGTTC
TACGCATAACCATGTCGTCACGGAACGCAGTGGTCGGATGTGCATATCTCGCTATGGCAG
TGCTTTTAACCTTGCTACTTGCGCAGCACCGTCGCGCCGGGCTGTGGATGGTTAGTGTAA
TTGATCGACCCTTCGCCATTTGCCTATTGCCTTAGTAGAATAATGCTTTATCTCTTAGAC
AAAAGTACACTTATTGAATCTAAAGCCAAATGATGGCGAGACCTTAGCCCGGGCGATCAT
TATATCTAAGCGCCCTGCTCCACACAGAGCAAGGAACTTCTATCTTCAAACATGTACGGT
TGTCCGCAAACCGCATCAGCGAGGCCGGTTTGCGAGACGGCTCAACACACGATGGTTGCC
GCTCACAGCGCATGGGACGACGAATGGCTAAGATTCTCAGGCAGCGAGGGTTGCACAAAT
TGGTTCACAACCGGTTCTCAGATTCGCTGCGTCTCATGGTACAGGAGGATGCGCTCAGAG
CGTCGAATACAAGGTCACCGATCGGTTGCTGTGCGCCCAATCATACCCGAAGTCTTTCGC
ATAGGCATCAGCACATTGGCGCTGGTCTGTGAAGCATTTACTGGTTGTCACCAAACTTCT
CGATAGGAGCGTGCCTGACCATCATCGCACCGTAGTTAAAATACCAAGAATACTGTAACA
TTACAAGTATTCAGGGCCTCTTATATATCACTGTCCCATCGTTCCTTTGGTAGGTAATTT
CAGTTAGCCGAGGCACATACAAACACTAGAGTGGACCTGGCCCTGCCTATCACAAGGCTA
AATGCTTACTACACTCGGAGACGGTAGGTGAATTTTACACTAGCCCGCCATCCGGGATAA
TTTGCGGCAGGCCATGTTAGAGTTGAGGTCCGCTCTCGCCTAGCATTCCCTTCAAACTGC
GTCGTTACTCG
>Rosalind_8694
CGAAGTAGCGAATATACGATCCGACAGCTTAAACTCGAGGGGTCCCCGCCGATCATCATC
GCGCTTGCCTCCACTTTCTCGTCCACCCCATAGTTTAGCGATAGGGGTTTAACGAACACC
TCTCGCACCACATATGAACTACTGGGTGGGACTTAGTAATTTATACGCAACCCAAGTACC
TGGTTACAAATTCTCTAGACCGCACAGGACAGTTGACATTAGGGTCCATCTATAGCTATG
TTGGTAGATTCGAACCCGATGCCGGCGGCGTTTAAGGCAAAGCTAACTTAGATCCGCAGC
ACAGGGCGTGCATCACCTACCCGTGATCCGTATCACTGCCGTTTGAAAACCGTCTGGCCT
CCAACACTGCAAGCATGAAACGGCTGTCTAGAGCACCAGCATTCTGTTGATACGATATCT
TAAGTCATGAGGGCCATGTAGCTTATATTTGAAATCAACTGGCATTTGCATCAGGTAAGA
GTTGACATGGGGAGCGTTCACGCCGGTAATCCTTAACAGAGTGTATGGAGCCTATAAAGG
GGTTATGCATGCGGTGGAATCTGTCCCCAATCTGGAGATTGACTGTTCGCTTATGTTGAA
CCGATCTTAAACGGTCTTCATTTCATCCCAGCGTAATACGACTCGATCGCTGTACACGGC
CCGGTAACTCCACAAGTCACACCCAACACTGCTGGTCCGACGTAGTAACCCTATGACGTA
AGCGCGGTCTGATCTATGGGCCGCTTTAGCAGGCGAGATACTAGATGACTCGCCCTCCAC
TGTGCCAGTTTAGGTCCCACCGGGAAATATGCTGTCTCACCAACCATGTCGCATAACATT
AGGTTGTTCCCACTTCGCGATATGGTCTATGAAAGAAACCCGGCATCAAGTGTTACTTTG
CCAGCAGACTGAAAGAAGTTTGCGAAGACGAGTTTTGTATGAGGTCACAGTAGGTCAACA
CCTCTTATTTC
>Rosalind_8825
CACCTGCCATATTGTCAAAGCATTACGTGGGAGATATCATGTCATGACGAAGCGCATAAA
CGGCTACTTATAATGCTGTAGCTACCGCGGCAAGGCCGCCGTTTTCCTAGGGCCCTTTGA
TAGTTAAATGACTTCACCAGTCGTCTCTTCAAAGGCCCAGACATGGTGCGTCCCCGTGCA
TCTGTACCATCTTCGTGTCGTAAATAGCGGAAAAACAGACCAATCCGTTAACTTAAACGG
CACGCAACTTACAGGTCCTGAGCTCTTCAATTTCACGGGCATGCTGAAACGGGGTGCTTT
AGTGCGCGGTCATCCCTACCTGCTATTACCTAGCATATAAAGGAGATTTGGAATCGGTAA
GAGTTTGGGCCACGTCGAAAAGGGGGCAGGTTCAGCTAGGATTGGAAAAGGCGAACCACT
CAGTTAGTGTCTGCGGAGAGTAGCATGCAGAGTGTCCATTGCAAGTGTGGACAGTTACGG
CACCTCAGCCTTGTCGGTCAGCGCCATATTGGGGCCGACTTAGCTGGGCACCAGACCACC
GTGCCTGTATGATTTAACCCAAGGTTGTGTCTCCGCCTTCGCATATACTACGCAACCTCC
AATGTTGAGCCCCTAGCGCCGGTCGGGCAGGTAAAATTAGAACTATGTGTAGCGGACGTA
TCTGGCACATAGTCTCGCCTCTAGGCCATATATCAGAAGGAAATCATCTATTGGTCCATG
GACATAGTGAGGATGGCTTGGGTTTTCTACCGTGGATCAGTCCGCAGCGAAGTTGCTGAA
AGAGAAAAGTAGGTTGTGACAGATGGGAACTGAAAACATGGCTTTTGATAGGATGATCCG
TCGAATCCTCTTGCCTCCATTCAGTGCTATGCGCCACTGACATGATTGAAAGAAGTAGGG
CCGCTTCAAGAGGGAGGCAACGTGGTATTTCTTAGGAGTATCGTTCACACTCCACTGGGC
AACTGGGCTCT
>Rosalind_1577
TTGGTTTTTGTCTTGTGGTAGCTATAAACGTGAGTCACTGCTATCGCATGCAATCTCAAC
TGAAGCGCATCCGTTCGGACCAGGACCAGCAAGCGGTTACAACGTGCCTGGCGGTTTGCC
TATTCTGAAAGCGTCTTATGGAACGCCTCATATCCTCGAAACAGCCTCCTTCGAGGTCAG
TGTGTGGTGTTCTCCAAGTCCTAATTAGTGCCCACAAAACGTGAAATCGTTGCCCGTCGA
CAGCCGTGTCGCAGATTTCCCGTTCGCATAGCTGGCGCACTGGCGTGTTACCCTACCAAT
GCCGCTGGGAAACTCTCCGTTTATTGGACCGGCAATCTAACGGATCACAATTCTGCGGTC
TCTATTTACAAGGCCGCCACGGAACGATCGCGATACCTTGGGAAGAGCGTAACCGCGTGC
ATGTACTGTGTGTACCAGACACTCGCCGTGTGCAACCTACCGGCCGCATTTTGATATGGT
TATAACCCCCGCACCATTTCACTTAGATATACACGGTGCAGGATCGGCTCCTGTGCCGGA
GGAGCGAGCGTTACGACAACGCTCAGCGCGACCTTTGCTACAGGAAACGGGAGTTTTTAT
GCGGGAAGACTACTCCGATGAAGAGGCCACCCTGTTAACAGTCCCGAGCTCCGTACTTAA
CTACGGTGTCCTATCTCGCGACGACACAGCAAAGATTAGCATACTGTTCAAGTCTCTGTT
GTAGTGGCCCTTACGGCCCGGCCCGAACATATACTGCGTCCAGTTAGCACTGTGTGATGA
CGGCATACCGAGGAGCCGTTGACGGTTCGCGTACAGTCGATGATGTATGTATCAAAGGGC
AAAGTCGCCTGGTTAATTATGTGCCTTGTGTGAGTACCCTTCGGCGTGCACCGATTGCGC
TGACCGACCGGTGATGACAGCCGAGTAGAGGTGCCAGTCGTGAGTAGCAATCCACAAACC
ATCAAACATTT
>Rosalind_6025
CGACCTTAGGGTGTGGGTCAATTGTCAATACTTGATCTACCACTATGGGTCTACTTGCAA
GGCCACGACACCGACACTTTATAGGGTGAGGTTTATGCACGGGCCTCATGAATAGAGATG
CTGTTTAGTAACTCGTATCAGCGGACTGCCATTAGGCTCACGATATGTCACGTTCATCAC
GAGGAAGATCCAAGAGTTGAACACCCCACAACGGTCAGACTTCCGTAACCGAGGCACGAC
GATTCTCGACGTCTCCGGGGCGACTTTGTCGATGACACTAATTACGGGGCTCTCCATCCT
TAGTTGCGCGGGTGAGCAACATTGGTTCTAAGCCGTTGGCTATTAGTTTACAGAACAAGC
CTCCGATCTGACGACCGACTTTCATCGAAATCTGGGTAACAATCCCACAGCCCAGGTTCC
CCACTATGCGTGTAGCGCAAAAAGTCACCGGTATTCTTCAGTGCGCGCGAAAAAAAAATT
TTCCGCCAGGTGGTTTTTTCGAGGAGAGCTAATGTCGCTAAAGACTTCGACTCGTCACGG
GGTACCAGAAGATCGTGTACGCTATCGCCCGATGCCATAGAAGAGATAACTAGAGTTAAG
ATGTCGCGAGATGGGTTTTAATCCCACCTACCAAGATTTCATTCGATACGGCAAAATAAT
ATTCCTCAATGGATGGAAACTTATCCCACTTGGAGACGTGGACTAATCCATAAAGTAGAG
GGGAGTCACAGTTTTCATTCTCGCCACATTCTTAATAACAGAAGCCAACCCGTTCATTGA
ATAGTCGCCTACACAGTCACTCGCAGCTTTCGGAGCTCCCGGGAGGTGGGGGAAAGAGTA
TGTTACAGGTTGGACGGTCATCATGGGCCCTTTTAGTAACTAACAGCGCCCGTCTGCTGG
AGTGACCCTAGCGTCAGTCTCAGTTGAAGTTTACCCAATATAGACGCCTCTGAGGCCGAT
TCTCTGACTTT
>Rosalind_2289
GGGCAAAACCGAGTGAACTTTTCCATTGTGAGAGGCTTCTGATGCTCTTCGCAACGCCTG
TAAACGTCTTAAAGTATGATTATAGGAATGTTTATCGACAAGTTCGAGTTGCGTGAACCG
CGTACACTTACACACCGTTAACCGTCTATCAGGCATTTCTGACGAGCATGCATATTATAC
GGCTTCGTTAGAGCCGGAGCCAGGCTTCGATAGGATTAGTTCATCTGTTGTAGTAAGGAC
TGACCGAGACGCGCAGTAGGAATTCTAAACACTACAGACCCTGGTTATATCACTACGAAA
GGTATCGTGCAAACACCTGCACGCTACGCCGCGCTGGGTGTCAGTCTACCATCCAGGCGT
TATCCAACGAACCGGTAGAAGAGCTCAGAATTCCCCGTCACGTATCCTCGGACGCACAAT
CTTGGAGTGCGAGCTGCAACTGGGCGTGTGCAGAATCCAGGGTTGCCACACAACACGATA
ATAACGTTCAAGTGTCTTTCGTTCTTGTGTTACACCGAACGTTGCGAGCCAATTCAGATG
CTCAGATAATTGATAGTCGAACCACTGGCTGATTCGACCAATTCTCCCTTGGCTCACCGA
GTCCTACTTAGTTTCTGTAATTAGCTGTGTTAAGTATTAAGAGCCCAGCAAGGTCGGTCT
GAATTAACTAGACTTCACAACAGGACTTTAGAGATGTCGCGAATCAACTTCGTTGATGAT
GCGGGTGATGGACCGATCCCCGACTACGTTGCAAGAAAAGCGCGTCGTTCGCCGAATCCA
AGGTTCCGCTCCGAGCCAACTCAGGACTGAGACTCTGTCCCTAAGCTGCACCCGCGGATG
ACGGTGTTCTATGTGTTCTCATCGGTGTCGAGTATAATATTAACGTTCATCTACCACCCG
GCGGAACTGTGCTAGACCAATGCGGTCGGACGCTATCATGATATGTGGACTCAAATAAGA
GTGCAAGTATG
